64
64
10
10
1
1
0#assets/tiles.png#0#0
1#assets/tiles.png#1#0
---
1#1#1#1#1#1#1#1#1#1
1#0#0#0#0#0#0#0#0#1
1#0#0#0#0#0#0#0#0#1
1#0#0#0#0#1#0#1#0#1
1#0#0#0#0#1#0#0#0#1
1#0#0#0#0#1#0#1#0#1
1#0#0#0#0#0#0#0#0#1
1#0#1#1#1#0#0#1#0#1
1#0#0#0#0#0#0#0#0#1
1#1#1#1#1#1#1#1#1#1
***
1#1#1#1#1#1#1#1#1#1
1#0#0#0#0#0#0#0#0#1
1#0#0#0#0#0#0#0#0#1
1#0#0#0#0#1#0#1#0#1
1#0#0#0#0#1#0#0#0#1
1#0#0#0#0#1#0#1#0#1
1#0#0#0#0#0#0#0#0#1
1#0#1#1#1#0#0#1#0#1
1#0#0#0#0#0#0#0#0#1
1#1#1#1#1#1#1#1#1#1
