64
64
20
20
1
1
0#TILE001#0#0
1#TILE001#1#0
2#TILE001#0#1
3#TILE001#1#1
---
1#1#1#1#1#1#1#1#1#1#1#1#1#1#1#1#1#1#1#1
1#0#0#0#0#0#0#0#0#0#0#0#0#0#0#0#0#0#0#1
1#0#0#0#0#0#0#0#0#0#0#0#0#0#0#0#0#0#0#1
1#0#0#0#1#1#0#1#1#0#0#0#0#0#0#0#0#0#0#1
1#0#0#0#1#0#0#0#1#0#0#0#0#0#0#0#0#0#0#1
1#0#0#0#0#0#0#0#0#0#0#0#0#0#0#0#0#0#0#1
1#0#0#0#1#0#0#0#1#0#1#1#0#1#1#0#0#0#0#1
1#0#0#0#1#1#0#1#1#0#1#0#0#0#1#0#0#0#0#1
1#0#0#0#0#0#0#0#0#0#0#0#0#0#0#0#0#0#0#1
1#0#0#0#1#1#0#1#1#0#1#0#0#0#1#0#0#0#0#1
1#0#0#0#1#0#0#0#1#0#1#1#0#1#1#0#0#0#0#1
1#0#0#0#0#0#0#0#0#0#0#0#0#0#0#0#0#0#0#1
1#0#0#0#1#0#0#0#1#0#0#0#0#0#0#0#0#0#0#1
1#0#0#0#1#1#0#1#1#0#0#0#0#0#0#0#0#0#0#1
1#0#0#0#0#0#0#0#0#0#0#0#0#0#0#0#0#0#0#1
1#0#0#0#0#0#0#0#0#0#0#0#0#0#0#0#0#0#0#1
1#0#0#0#0#0#0#0#0#0#0#0#0#0#0#0#0#0#0#1
1#0#0#0#0#0#0#0#0#0#0#0#0#0#0#0#0#0#0#1
1#0#0#0#0#0#0#0#0#0#0#0#0#0#0#0#0#0#0#1
1#1#1#1#1#1#1#1#1#1#1#1#1#1#1#1#1#1#1#1
***
1#1#1#1#1#1#1#1#1#1#1#1#1#1#1#1#1#1#1#1
1#0#0#0#0#0#0#0#0#0#0#0#0#0#0#0#0#0#0#1
1#0#0#0#0#0#0#0#0#0#0#0#0#0#0#0#0#0#0#1
1#0#0#0#1#1#0#1#1#0#0#0#0#0#0#0#0#0#0#1
1#0#0#0#1#0#0#0#1#0#0#0#0#0#0#0#0#0#0#1
1#0#0#0#0#0#0#0#0#0#0#0#0#0#0#0#0#0#0#1
1#0#0#0#1#0#0#0#1#0#1#1#0#1#1#0#0#0#0#1
1#0#0#0#1#1#0#1#1#0#1#0#0#0#1#0#0#0#0#1
1#0#0#0#0#0#0#0#0#0#0#0#0#0#0#0#0#0#0#1
1#0#0#0#1#1#0#1#1#0#1#0#0#0#1#0#0#0#0#1
1#0#0#0#1#0#0#0#1#0#1#1#0#1#1#0#0#0#0#1
1#0#0#0#0#0#0#0#0#0#0#0#0#0#0#0#0#0#0#1
1#0#0#0#1#0#0#0#1#0#0#0#0#0#0#0#0#0#0#1
1#0#0#0#1#1#0#1#1#0#0#0#0#0#0#0#0#0#0#1
1#0#0#0#0#0#0#0#0#0#0#0#0#0#0#0#0#0#0#1
1#0#0#0#0#0#0#0#0#0#0#0#0#0#0#0#0#0#0#1
1#0#0#0#0#0#0#0#0#0#0#0#0#0#0#0#0#0#0#1
1#0#0#0#0#0#0#0#0#0#0#0#0#0#0#0#0#0#0#1
1#0#0#0#0#0#0#0#0#0#0#0#0#0#0#0#0#0#0#1
1#1#1#1#1#1#1#1#1#1#1#1#1#1#1#1#1#1#1#1
+++
1#1#NPC001#Hi I'm Bob#How are you doing today?
%%%
2#2#0
2#3#1
